NO ./assets/textures/tex_s.xpm
EA ./assets/textures/tex_e.xpm
SO ./assets/textures/tex_n.xpm
WE ./assets/textures/tex_w.xpm
C 225,30,0
F 220,100,0


111111111111111111111
100000000000000000001
1000000000000000000N1
111111111111111111111