NO ./assets/textures/tex_n.xpm
EA ./assets/textures/tex_e.xpm
SO ./assets/textures/tex_s.xpm
WE ./assets/textures/tex_w.xpm
C 225,30,0
F 220,100,0


1111
1001
1S01
1111

