NO ./path_to_north_texture
EA ./path_to_the_east_texture
SO ./path_to_the_south_texture
WE ./path_to_the_west_texture
C 225,30,0
F 220,100,0


111111111111111
100000000000001
1011000000001
111111111111111

