NO ./assets/textures/tex_n.xpm
EA ./assets/textures/tex_e.xpm
SO ./assets/textures/tex_s.xpm
WE ./assets/textures/tex_w.xpm
C 225,30,0
F 220,100,0


111111111111111111111111111111111111111111111111111111111111
100000000000000000000000000000000000000000000000000000000011
100000000000000000001111100000000000000000000000000000000011
100000000000011111100000011111000000000000000000000000000011
100000000000000000000000000000000000000000000000000000000011
100000000000000000000000000000000000000000000000000000000011
10000000000000111110000000000000000000000000000000000000000011
1000000000000000000000000000000000100000000000000000000000000011
10000000000000000000000000000000000000000000000000000000001111
100000000000000000000000000000000000000000000000000000000011
100000000000000000000000000000000000000000000000000000000011
1000000000000000000000000000N0000000000000000000000000000011
100000000000000000000000000000000000000000000000000000000011
111111111111111111111111111111111111111111111111111111111111