111
1S1
11111
NO ./path_to_north_texture
SO ./path_to_south_texture
WE ./path_to_west_texture
EA ./path_to_east_texture

C        1,30,5
F        220,10,5

111
1S1
11111