NO ./assets/textures/nas2.xpm
EA ./assets/textures/nas3.xpm



SO ./assets/textures/nas2.xpm




WE ./assets/textures/nas3.xpm
C 225,30,0


F 0,100,0





111111111111111111111111111111111111111111111111111111
100000000000000000000000000000000000000000000000000001
100000000000000000000000000000000000000000000000000001
100000000000000000000000000000000000000010000000000001
100000000000000000000000000000000000000000000000000001
100000001100000000000000000000000000000000000000000001
100000000000000000000000000000000000000000000000000001
100000000000000000000000000000000011000000000000000001
100000000000000000000000000000000000000000000000000001
100000000000000000000000000000000000000000000000000001
100000000110000000000000000000000000000000000000000001
100000000000000000000000000000000000000000000000000001
100000000000000000000000000000000000000000000000000001
100000000000000000000000000000000000000000000000000001
100000000000000000000000000000000000000000000000000001
100000000000000000000000000000000000000000000000000001
1000000000000000000000000000N0000000000000000000000001
111111111111111111111111111111111111111111111111111111