NO ./assets/textures/nas2.xpm
EA ./assets/textures/nas3.xpm



SO ./assets/textures/nas2.xpm




WE ./assets/textures/nas3.xpm
C 10,15,30


F 35,30,15   





1111111111111111111111111
1N00100010000010001000001
1110101110111010111010111
1000001000100010001000101
1011101111101111101111101
1010001000001000100010001
1010111011101110111010111
1000100010000010001000101
1111101110111110111110101
1000001000000010000010001
1011111111111011111011111
1000100010000010000010001
1110111010111110111110111
1000100000001000000000001
1111111111111111111111111

